--------------------------------------------------------------------------------------------------------------------------------------------------------------------------------------------------------
------------------------------------------------------------------------------------------------------------------------------------------------------------E-------------------------------------------
-----------------------------------X------E----------------E-------------------------E-----------------E----------------------------?E----------------------X-EX----------------------------------------
----BB---BB------BB---BB---BB----BB------BB----------------BB-----------BB------E----B-o--X------------B---BB-------BB--BB--BB-------BBB----------BB------E--BB---BB-BB---X-----BB------------BB--------
-------BB------BB-----------X-B-------?--BB-?--X------BB------------------BBB--BB-?--X?------BB-------?-----BB-BB-?---------------------BB----X-----------Bo---o-BB----?BB--BB----BB--------------------
--------E------E----------E------------------------------------------------E---E--------E------------E------------------E-----------------------------------------------------------E-------------------
--------BB-----BB-X-----?-X---B--BB-----------X---------E----EB---------E-BB--BB--------BB----BB-?E--BB--------X-BBX---BBBBB---------EE-----B----E--------BBX-?-?--XoX------X-------X-------------------
--BB--BB----X--------?-------X--------?----X---------BB-X----BB---X-----BB-BB-X---B--------BB-BBBBB----B-?----------------E-------BBBBB------M---BB------E--BB----BB------BB-BB--BBB----X-BB--BB-----v--
--------M--------BB-?-?-B-------BB------BB-----------BBB---------X------------B---BBX-X------B----BB-BBX-----B--?M-BB---BBB-----B---------------------?BBBo---BBBBBB-----BB--X----------BBB------o---f--
----------------------E--------E------------?------------------------------------------------------------E----------------------------------------------------------------E--------------------------f--
-----------------X---BB-E--X----X-E---E-BB--------X----?--B--------T---o---B----B-------BB-------------B-BB--B-X------------T-?--TBBB?MX------T-E---o-------E-EXBB--E-----BB------------------X-X----f--
-----T---BBBB--BB------?--B----T--BB--BB----------BBX-----X--------|---------------------o-----X-----------------------B---X|-X-B|B---BB--T---|-BB-----?---BBBB----BB---------------B--T-----?-------f--
-----|---------------------E---|-----------------------------E-----|------------E---------E-------E-----------------------E-|----|--------|---|---------------------E------------------|-------------f--
-----|B------XoBBB--M-X--T-BB--|---BBB-------------------T--BB-----|X-----BBX---BB------X-BBB-----B----B-------------T-B--BB|X---|----X---|-T-|B------BB------------X---B---T---T------|-------BB----f--
m----|-ET---------EoEE---|----E|----EE--------T-o---o---o|---------|--------E-T-----E-o---E--------T----T---------Eo-|--EEEE|--o-|-E------|T|E|--------------E-oE-E---TEoo-o|---|-oo---|o-oo--o--Xoo-f--
XXXXX|-X|XXXXXXXXXXXXX---|XXXXX|---XXXXXXXX--X|XX---XXXXX|XXXXXXXXX|XX---XXXXX|XXX--X---XXXXXXXXXX-|XXXX|--XX-XXXXXXX|XXXXXX|XXXX|XXXXXXXX|||X|--XXX--XXXXXXXXX-XXXXXX|XX--X|XXX|XXXXXX|XXXX-XXXXXXXXXXX
