XXXXXXXXXXXXXXXXXXXXXXXXXXXXXXXXXXXXXXXXXXXXXXX
X377428956754974738411111115687685664728597458X
X972463826650773971164565461164564556974738287X
X83959772645967781X958685676X15437554787329643X
X5478732964359581X37742895675X1543583959772645X
X5697473828776981X97246382665X1947697246382665X
X6472859745858791X83959772645X1595737742895675X
X5797765795769671X54787329643X1654334543885474X
X6978697968779781X56974738287X1595697784386538X
X3243743534743951X64728597458X1954385852485282X
X2438654365698571X83959772645X1583968965367533X
X4535784397865951X56974738287X1596974969732342X
X6597679478654651X37742895675X1595748694749684X
X4327843586711171X54787329643X1511194759842932X
X6598237581165417X64728597458X7143511593682672X
X6798658915786586X97246382665X8592395139542878X
X45386591XXXXXXXXXXXXXXXXXXXXXXXXXXXXX15238952X
X569769616865668675868aXd486947496749417984944X
X6587695715869575957518X5155867485966159455696X
X5869579681166583581b67X43c1584964911954986833X
X9586965786911111119667X5569111111169697496968X
XXXXXXXXXXXXXXXXXXXXXXXXXXXXXXXXXXXXXXXXXXXXXXX